artist	genres
3OH!3	dance pop, electropowerpop, emo, pop, pop punk, pop rap, post-teen pop
68	mathcore, progressive post-hardcore
5606	No data
A+ Dropouts	No data
Aaron West and the Roaring Twenties	alternative emo, anthem emo, pop punk
Abriel	Deathcore, Pop, Metalcore
The Acacia Strain	christian hardcore, death core, djent, mathcore, melodic metalcore, metalcore, progressive deathcore, rap metal, screamo
The Academy Is...	dreamo, emo, pop emo, pop punk, screamo
A Day to Remember	metalcore, pixie, pop punk, screamo
Adolescents	crossover thrash, hardcore punk, melodic hardcore, oi, punk, ska punk, skate punk
After the Burial	death core, djent, groove metal, mathcore, melodic metalcore, metalcore, rap metal, screamo
Against the Current	pixie, pop emo, pop punk, post-teen pop, viral pop
Agent Orange	crossover thrash, hardcore punk, punk, ska punk, skate punk
Aiden	emo, horror punk, metalcore, screamo
The Alarm	dance rock, indie christmas, jangle pop, new romantic, new wave, new wave pop, power pop, welsh rock
Alesana	emo, metalcore, pixie, pop punk, post-hardcore, screamo
Alestorm	comic, folk metal, metal, power metal, progressive metal, speed metal
Alive Like Me	pixie, post-screamo
Alkaline Trio	emo, melodic hardcore, pop punk, pop rock, punk, screamo, skate punk
The All-American Rejects	emo, neo mellow, pop, pop punk, pop rock, post-grunge
All That Remains	alternative metal, groove metal, melodic metalcore, metalcore, nu metal, post-grunge, rap metal, rap rock, screamo
All Time Low	pixie, pop, pop punk, post-teen pop, punk christmas, teen pop
Allister	emo, pop punk, punk, skate punk
Allstar Weekend	alternative pop rock, pop, post-teen pop, teen pop, viral pop
The Almost	christian alternative rock, christian christmas, christian metal, christian rock, dreamo, emo, pop punk, punk christmas, screamo
Alvarez Kings	sheffield indie
AM Taxi	No data
Amazing Royal Crowns	deep psychobilly
Amber Pacific	emo, piano rock, pop emo, pop punk, screamo
Amely	alternative pop rock, pop emo, pop punk, punk christmas
American Authors	brooklyn indie, indie poptimism, neo mellow, pop, pop rock
American Opera	No data 
American Pinup	No data
American Sixgun	modern southern rock
The Amity Affliction	metalcore, pixie, post-screamo, screamo
Amory	No data
Amplify This	triangle indie
Amyst	No data
A.N.I.M.A.L.	alternative dance, alternative rock, anti-folk, chamber pop, chillwave, dance-punk, dream pop, escape room, experimental rock, folk-pop, freak folk, indie folk, indie pop, indie r&b, indie rock, indietronica, lo-fi, neo-psychedelic, new rave, noise pop, noise rock, nu gaze, post rock, shimmer pop, synthpop
Anarbor	emo, pixie, pop emo, pop punk, punk christmas
Anberlin	alternative metal, christian alternative rock, christian christmas, christian rock, dreamo, emo, nu metal, pop punk, pop rock, post-grunge, punk christmas, screamo
And I've Landed	No data
Andrew W.K.	comic, pop punk
Andy Black	pixie, pop punk
Angels & Airwaves	emo, pop rock, post-grunge, space rock
Angry Samoans	crossover thrash, hardcore punk, punk
Animo	No data
Anthony Raneri of Bayside	No data
Anthrophobia	No data
Anti-Flag	melodic hardcore, pop punk, punk, ska punk, skate punk
Antiserum	No data
April Chase	No data
Assuming We Survive	anthem emo, pixie
The Aquabats	comic, punk, ska, ska punk, skate punk
Architects	mathcore, melodic metalcore, metalcore, rap metal, screamo
Armor for Sleep	dreamo, emo, pop punk, post-hardcore, progressive post-hardcore, screamo
The Arrogant Sons of Bitches	folk punk, ska, ska punk
Artist Vs Poet	alternative pop rock, indie rockism, pixie, pop emo, pop punk, punk christmas
As Cities Burn	christian hardcore, christian metal, christian punk, dreamo, metalcore, post-hardcore, progressive post-hardcore, screamo
Ascot Royals	anthem emo
As I Lay Dying	alternative metal, christian metal, death core, groove metal, melodic death metal, melodic metalcore, metalcore, nu metal, rap metal, screamo
As It Is	anthem emo, pixie, pop emo, pop punk
As Tall as Lions	dreamo, progressive post-hardcore
Asking Alexandria	alternative metal, melodic metalcore, metalcore, pixie, pop punk, rap metal, screamo
Assorted Jelly Beans	crack rock steady, punk, ska, ska punk, skate punk
The Ataris	emo, melodic hardcore, pop punk, pop rock, punk, skate punk
A Thorn for Every Heart	screamo
Atmosphere	alternative hip hop, hip hop, pop rap, underground pop rap
Atomic Fireballs	swing, traditional swing
Atreyu	alternative metal, emo, groove metal, melodic metalcore, metalcore, nu metal, pop punk, post-grunge, rap metal, rap rock, screamo
Attack Attack!	downtempo, electronic, nu jazz, trip hop
Attila	death core, melodic metalcore, metalcore, pixie, rap metal, screamo
The Audition	dreamo, emo, pop emo, pop punk, screamo
August Burns Red	christian christmas, christian metal, death core, heavy christmas, melodic metalcore, metalcore, pop christmas, punk christmas, rap metal, screamo
Authority Zero	melodic hardcore, pop punk, punk, reggae rock, ska, ska punk, skate punk
The Automatic	Indie rock, alternative rock, post-punk revival, post-hardcore, dance-punk 
Automatic Loveletter	emo, pop rock
Avail	melodic hardcore, orgcore, punk, skate punk
Avenged Sevenfold	alternative metal, alternative rock, nu metal, pop punk, post-grunge, rock
Avion Roe	pixie, pop emo
A Wilhelm Scream	alternative emo, emo, melodic hardcore, orgcore, pop punk, punk, skate punk
Baby Baby	No data
Bad Cop / Bad Cop	power-pop punk, skate punk
Bad Rabbits	boston rock
Bad Religion	alternative rock, funk rock, melodic hardcore, pop punk, punk, punk christmas, rock, skate punk
Bad Omens	metalcore, pixie, post-screamo, screamo
Bad Seed Rising	pixie, pop emo, post-screamo
The Ballroom Charades	No data
Ballyhoo!	reggae rock
Bangups	No data
Barb Wire Dolls	Grunge, Punk rock
Bayside	alternative emo, anthem emo, dreamo, emo, pop punk, post-hardcore, screamo
Beacher's Madhouse	No data
Beartooth	columbus ohio indie, emo, metalcore, pixie, pop punk, rap metal, screamo
Beatsteaks	deep german pop rock, german hip hop, german indie, german pop, german punk, reggae fusion
Beat Union	Pop punk
Beautiful Bodies	pixie, pop emo
Bebe Rexha	dance pop, edm, pop, post-teen pop, tropical house
Beck	alternative rock, anti-folk, classic rock, electronic, folk christmas, funk rock, garage rock, indie christmas, indie pop, indie rock, neo-psychedelic, permanent wave, pop rock, rock, singer-songwriter
Bedouin Soundclash	reggae rock
Beebs and Her Money Makers	ska
Being As An Ocean	alternative emo, anthem emo, metalcore, pixie, screamo
Between the Trees	alternative pop rock, dreamo, emo, piano rock, pop emo, pop punk
Beware Of Darkness	No data
Be Your Own Pet	dance-punk, garage rock, riot grrrl
Bif Naked	canadian indie, candy pop, lilith
Biffy Clyro	garage rock, indie rock, rock, scottish rock
Big B	east coast hip hop, gangster rap, hardcore hip hop, hip hop, pop rap, rap, southern hip hop
Big Chocolate	death core, electronic trap
Big D and the Kids Table	folk punk, punk, punk christmas, ska, ska punk, skate punk
Big Drill Car	Punk rock, pop punk, melodic hardcore
Bi-Level	No data
Billy Idol	album rock, classic rock, dance rock, glam metal, hard rock, heavy christmas, mellow gold, new romantic, new wave, new wave pop, rock, soft rock, synthpop
Billy Talent	alternative metal, emo, nu metal, pop punk, post-grunge, punk
Black Boots	No data
Black Box	disco house, eurodance, europop, hip house, vocal house
The Black Dahlia Murder	death core, death metal, deathgrind, djent, groove metal, mathcore, melodic death metal, melodic metalcore, metal, metalcore, technical death metal
The Black Eyed Peas	dance pop, pop, pop rap, post-teen pop
Blackfire	Punk rock, alternative rock
The Black Pacific	melodic hardcore, skate punk
Black Square	punk ska
Black Tide	groove metal, melodic metalcore, metalcore
Blacklist Royals	alternative roots rock, orgcore
Black President	Punk rock, hardcore punk
Black Veil Brides	alternative metal, emo, metalcore, pixie, pop punk, rap metal, screamo
Blas√© Debris	No data
The Bled	mathcore, melodic metalcore, metalcore, post-hardcore, progressive post-hardcore, screamo
The Bleeding Irish	celtic punk
Bleeding Orange	No data
Bleeding Through	christian hardcore, christian metal, death core, groove metal, melodic metalcore, metalcore, nu metal, rap metal
Bleed the Dream	punk christmas, screamo
Blessthefall	melodic metalcore, metalcore, pixie, post-screamo, rap metal, screamo
Blink-182	heavy christmas, pop punk, punk, punk christmas
Blood on the Dance Floor	electropowerpop, pixie, screamo
Bombay Cowtippers	No data
Born Cages	indie poptimism, indie psych-rock, indie rockism
Born of Osiris	death core, djent, groove metal, mathcore, melodic metalcore, metalcore, rap metal, screamo
Boston Manor	alternative emo, anthem emo, pixie, pop punk
The BOTS	No data
Bouncing Souls	emo, melodic hardcore, pop punk, punk, ska, ska punk, skate punk
Bowling for Soup	comic, emo, heavy christmas, pop punk, pop rock, post-grunge, punk, punk christmas, skate punk
Box Car Racer	emo, pop punk, punk, screamo, skate punk
BoyMeetsWorld	anthem emo
Boysetsfire	melodic hardcore, skate punk
Boys Like Girls	emo, neo mellow, pixie, pop, pop emo, pop punk, pop rock, post-teen pop, viral pop
Boys Night Out	alternative emo, dreamo, emo, melodic hardcore, pop punk, post-hardcore, progressive post-hardcore, screamo
Brand New	alternative emo, emo, pop punk, pop rock, screamo
Brass Tackz	No data
Breathe Carolina	big room, deep big room, edm, electro house, electropowerpop, emo, pixie, pop punk, progressive electro house, punk christmas, screamo
Breathe Electric	alternative pop rock, electropowerpop
Brian Marquis	folk, americana, whiskey
Britt Black	rock
The Briggs	celtic punk, heavy christmas, melodic hardcore, oi, punk, punk christmas, ska punk, skate punk
Bring Me The Horizon	alternative metal, metalcore, pixie, pop punk, screamo
Broadway Calls	alternative emo, melodic hardcore, orgcore, pop punk
Broadside	alternative emo, anthem emo, pixie, pop emo, pop punk
BrokeNCYDE	electropowerpop, pixie, screamo
The Bronx	garage rock, melodic hardcore, post-hardcore, punk, skate punk
Brothers Of Brazil	brazilian punk, rock gaucho
Buck-O-Nine	ska, ska punk, skate punk
Buffalo Casket	No data
Bullet For My Valentine	alternative metal, groove metal, melodic metalcore, metalcore, nu metal, pop punk, post-grunge, rap metal, rap rock, screamo
The Bunny The Bear	electropowerpop, pixie, post-post-hardcore, post-screamo, screamo
Burning Empires	No data
Buttons	No data
Call the Cops	alternative pop rock, electropowerpop
Callback California	No data
Campaigning For Zeros	No data
Candiria	jazz metal, mathcore, metalcore, rap metal, rap rock
Candy Hearts	alternative emo, candy pop, power-pop punk
Cane Hill	Nu metal, metalcore, alternative metal
Capsize	alternative emo, anthem emo, progressive post-hardcore
Captain Capa	electropunk, german indie
Carnifex	death core, melodic metalcore, metalcore, progressive deathcore, technical death metal
Carousel Kings	alternative emo, anthem emo, deep pop punk, pixie, pop emo, pop punk, post-screamo
Cartel	latin hip hop
Casket Architects	No data
The Casualties	crossover thrash, hardcore punk, oi, punk, ska punk, skate punk
CatchingYourClouds	alternative pop rock, pixie
Champagne Champagne	classic funk rock, disco, funk, funk rock, motown, post-disco, quiet storm, soul, urban contemporary
Charged GBH	brazilian punk, crossover thrash, hardcore punk, oi, punk, ska punk, skate punk
The Chariot	chaotic hardcore, christian hardcore, christian metal, dreamo, mathcore, melodic metalcore, metalcore, progressive post-hardcore, screamo
Charlotte Sometimes	acoustic pop, candy pop, deep talent show, folk-pop, lilith
Chase Long Beach	ska, ska punk
Chase Walker Band	Rock, Blues, Jazz
Chelsea Grin	death core, melodic metalcore, metalcore, rap metal, screamo
Cherri Bomb	hard rock
Cherry Poppin' Daddies	ska, ska punk, swing, traditional swing
Chiodos	emo, metalcore, pop punk, post-hardcore, progressive post-hardcore, screamo
The Chop Tops	deep psychobilly, psychobilly, rockabilly
Chuck Ragan of Hot Water Music	Folk rock, punk rock, folk punk
Chunk! No, Captain Chunk	anthem emo, emo, metalcore, pixie, pop emo, pop punk, post-screamo, screamo
ChrisB	No data
Cinder Road	grunge pop, hard alternative
Cinematic Sunrise	emo, piano rock, pop emo, pop punk
Circa Survive	alternative emo, dreamo, emo, pop punk, post-hardcore, progressive post-hardcore, screamo
Circle Jerks	crossover thrash, funk rock, grunge, hardcore, hardcore punk, oi, punk, ska punk, skate punk
Citizen	neo mellow, pop rock
Citizen X	No data
CIV	hardcore, melodic hardcore, skate punk, straight edge
TheCityShakeUp	No data
CKY	alternative metal, groove metal, heavy christmas, industrial metal, metalcore, nu metal, post-grunge, rap metal, rap rock
The Classic Crime	christian alternative rock, christian rock, dreamo, indie rockism
The Cleopatra Complex	electronica, alternative rock, pop
Close Your Eyes	christian hardcore, christian metal, metalcore, screamo
Closure in Moscow	dreamo, progressive post-hardcore, screamo
Cobra Starship	dance pop, emo, pop, pop punk, pop rap, pop rock, post-teen pop
Coheed and Cambria	alternative metal, emo, pop punk, screamo
Coldrain	j-metal, post-screamo
Cold Forty Three	pop, punk
Cold Fusion	martial industrial, neofolk
The Color Fred	dreamo, emo, pop punk
The Color Morale	melodic metalcore, metalcore, pixie, post-screamo, progressive post-hardcore, screamo
Columbyne	No data
The Confession	melodic metalcore, metalcore
Confide	metalcore, progressive post-hardcore, screamo
Continental	tico
The Constellations	Hip hop, rock
Counterparts	alternative emo, anthem emo, canadian metal, death core, deep melodic metalcore, melodic hardcore, metalcore, progressive post-hardcore, screamo
Courage My Love	metropopolis, pixie, pop emo
Corrin Campbell	alternative rock, Rock
Crashcarburn	deep pop emo, pop emo
Creeper	alt-indie rock, pixie
Crime in Stereo	alternative emo, emo, melodic hardcore, pop punk, straight edge
Crizzly	brostep, electronic trap
Crossfaith	j-metal, j-rock, metalcore, screamo
Crown the Empire	metalcore, pixie, pop punk, post-post-hardcore, post-screamo, punk christmas, screamo
Crowned King	No data
Cruel Hand	alternative emo, chaotic hardcore, hardcore, melodic hardcore, straight edge
Culture Shock Camp	No data
Cursed Sails	No data
Cute Is What We Aim For	emo, pixie, pop emo, pop punk, pop rock, screamo
D12	crunk, detroit hip hop, dirty south rap, gangster rap, hardcore hip hop, hip hop, pop rap, rap, southern hip hop
The Damned	alternative rock, dance rock, experimental rock, garage rock, gothic rock, hardcore punk, new wave, new wave pop, post-punk, power pop, pub rock, punk, punk blues, uk post-punk
Dance Gavin Dance	emo, metalcore, pixie, pop punk, progressive post-hardcore, screamo
Dance Hall Crashers	ska, ska punk, skate punk
The Dance Party	Rock, new wave, dance-punk, power pop
Dangerkids	pixie, post-screamo, screamo
Danger Radio	alternative pop rock, pop emo
The Dangerous Summer	alternative emo, anthem emo, dreamo, emo, pixie, pop emo, pop punk
Danielle Barbe	deep indie singer-songwriter
Dante	tropical house
Darkest Hour	alternative metal, christian metal, death core, djent, groove metal, mathcore, melodic death metal, melodic metalcore, metalcore, nu metal
The Darlings	columbus ohio indie
Dash | Ten	No data
DC Fallout	fast melodic punk
Dead Cat Lounge	No data
Dead Legend	No data
Dead Sara	No data
The Dear & Departed	No data
Dear and the Headlights	dreamo, pop punk, progressive post-hardcore
Defeater	alternative emo, anthem emo, chaotic hardcore, melodic hardcore, pop punk, screamo
Deftones	alternative metal, alternative rock, funk rock, groove metal, nu metal, post-grunge, rap metal, rap rock, rock
Demerit	chinese indie rock, street punk
Descendents	alternative rock, emo, hardcore punk, pop punk, punk, ska punk, skate punk
Deviates	melodic hardcore, punk, skate punk
The Devil Wears Prada	christian metal, death core, melodic metalcore, metalcore, rap metal, screamo
Desperation Squad	Avant-garde, Punk Rock, Outsider Music
D.I.	bolero, latin pop, romantico
Dick Dale	rockabilly, surf music
The Dickies	crossover thrash, hardcore punk, heavy christmas, oi, power-pop punk, pub rock, punk, punk christmas, skate punk
Die' Hunns	oi
Die Toten Hosen	deep german pop rock, german pop, german punk
The Dillinger Escape Plan	alternative metal, death core, djent, funk rock, groove metal, jazz metal, mathcore, melodic metalcore, metalcore, nu metal, post-hardcore, post-metal, sludge metal
The Dirty Nil	indie punk
Disco Ensemble	suomi rock
District 7	Punk rock, Pop punk, Melodic hardcore, Skate punk, Hardcore punk
Divided By Friday	alternative pop rock, pixie, pop emo, punk christmas
DJ Nicola Bear	No data
DJ Scout	No data
Dodger	No data
Does It Offend You, Yeah?	alternative dance, dance-punk, electroclash, indietronica, new rave, synthpop
Doll Skin	Rock, Punk Rock, Alternative Rock, Pop punk
Doozer	No data
Double XL	No data
Down by Law	melodic hardcore, power-pop punk, punk, skate punk
Drama Club	grunge pop, post-screamo
Dr. Madd Vibe	No data
Dr. Manhattan	Alternative rock, indie rock, electronic
Drive A	metalcore, pixie, pop emo, post-screamo, screamo
Driver Friendly	rock
Drop Dead, Gorgeous	metalcore, nintendocore, post-hardcore, progressive post-hardcore, screamo
Dropkick Murphys	boston rock, celtic punk, celtic rock, pop punk, punk, skate punk
D.R.U.G.S.	alternative rock, chamber pop, chillwave, dream pop, folk-pop, freak folk, indie folk, indie pop, indie rock, indietronica, neo-psychedelic, noise pop, roots rock, singer-songwriter, stomp and holler
Dose Of Adolescence	No data
The Dukes	alternative country, country rock, folk, folk rock, mellow gold, new americana, outlaw country, rock, roots rock, singer-songwriter, southern rock, texas country, traditional country, traditional folk
Dustin Jones and the Rising Tide	No data
The Early November	alternative emo, anthem emo, dreamo, emo, pop punk, post-hardcore, screamo
Echo Movement	reggae rock
Echosmith	neo mellow, pop, pop christmas, viral pop
Eden Row	No data
Edreys	Hip hop
Eighteen Visions	christian hardcore, mathcore, melodic metalcore, metalcore
Eightyonedays	No data
Electric Touch	lo star, piano rock
Eli Olsberg	No data
Emarosa	emo, metalcore, pixie, pop punk, post-hardcore, progressive post-hardcore, screamo
Emery	big room, deep big room, edm, electro house, progressive electro house, progressive house, progressive trance, trance, tropical house, uplifting trance
Emilie Autumn	cello, dark cabaret, steampunk, symphonic metal
Emily's Army	punk rock
Eminem	detroit hip hop, g funk, hip hop, pop rap, rap
Emmure	death core, groove metal, melodic metalcore, metalcore, nu metal, rap metal, screamo
Enough Already	No data
Enter Shikari	alternative metal, emo, metalcore, nintendocore, nu metal, pop punk, post-hardcore, rap metal, screamo
Entice	No data
Envy On The Coast	dreamo, emo, pop punk, progressive post-hardcore, screamo
Escape The Fate	alternative metal, emo, metalcore, pixie, pop punk, post-grunge, rap metal, screamo
Esham	detroit hip hop, horrorcore
Eternal Boy	Pop Punk
Evaline	dreamo
Evelynn	No data
Evergreen Terrace	christian hardcore, death core, melodic hardcore, melodic metalcore, metalcore
Every Avenue	alternative pop rock, emo, pixie, pop emo, pop punk
Every Time I Die	chaotic hardcore, dreamo, emo, mathcore, melodic metalcore, metalcore, pop punk, post-hardcore, progressive post-hardcore, screamo
The Expendables	reggae rock
The Exposed	No data
Eyes Set To Kill	melodic metalcore, metalcore, pixie, pop emo, screamo
The Fabulous Rudies	No data
Face to Face	emo, melodic hardcore, pop punk, punk, ska punk, skate punk
Face The King	No data
Fall From Grace	Alternative rock, Alternative Metal, Hardcore punk
The Fall of Troy	mathcore, metalcore, nintendocore, post-hardcore, progressive post-hardcore, screamo
Fall Out Boy	emo, pop punk
Falling In Reverse	metalcore, pixie, pop punk, rap metal, screamo
Falling Through April	No data
False Puppet	No data
Family Force 5	ccm, christian alternative rock, christian christmas, christian hip hop, christian music, christian rock
The Fantastic Plastics	No data
Farewell	anthem emo, pixie
Farewell Winters	No data
Fear	alternative metal, death metal, funk rock, groove metal, industrial metal, industrial rock, latin metal, melodic death metal, melodic metalcore, metal, nu metal, post-grunge, progressive metal, rap metal, rap rock, rock, speed metal, thrash metal
Fear Before the March of Flames	dreamo, mathcore, metalcore, nintendocore, post-hardcore, progressive post-hardcore, screamo
Fear Nuttin' Band	rap metal, rap metalcore, rap rock
Feeki	deep underground hip hop, redneck, underground pop rap
Fenix TX	emo, pop punk, punk, ska punk, skate punk
The Figgs	jangle pop, power pop
The Fight	hard alternative, post-screamo
Fight Fair	alternative emo, deep pop punk, pop punk
Fight Fight Fight	alternative emo, anthem emo, emo, indie punk, melodic hardcore, pop punk, screamo
The Fighting Jacks	No data
Final Summation	No data
Finch	Post-hardcore, alternative rock
Fire From The Gods	post-screamo
Fireworks	alternative emo, punk christmas
First To Eleven	post-screamo
Fishbone	funk metal, funk rock, rap rock, ska, ska punk
Fit For a King	death core, melodic metalcore, metalcore, post-screamo, rap metal, screamo
Five Iron Frenzy	christian alternative rock, christian punk, christian rock, ska, ska punk
Five Knives	No data
The F-Ups	pop punk
The Flatliners	alternative emo, folk punk, melodic hardcore, orgcore, pop punk, punk, ska, ska punk, skate punk
Flogging Molly	bow pop, celtic punk, celtic rock, comic, pop punk, punk, skate punk
Florence	folk-pop, indie pop, pop
Fluf	alternative pop
The Fold	antiviral pop, christian alternative rock, christian christmas, christian rock, dreamo
For All Those Sleeping	metalcore, pixie, post-screamo, punk christmas, screamo
For The Foxes	electropowerpop, indie rockism
For Today	christian hardcore, christian metal, death core, melodic metalcore, metalcore, screamo
Forever Came Calling	alternative emo, anthem emo, pixie, pop emo, pop punk
Forever The Sickest Kids	alternative pop rock, electropowerpop, emo, pixie, pop emo, pop punk, punk christmas, screamo
Forget Me In Vegas	pop emo
Four Year Strong	alternative emo, anthem emo, emo, melodic hardcore, metalcore, pixie, pop emo, pop punk, punk, screamo, skate punk
Foxy Shazam	piano rock
Freshman 15	deep pop punk, pop punk
From Ashes To New	alternative metal, nu metal, post-grunge, post-screamo, rap metal, rap rock
From Autumn to Ashes	emo, melodic metalcore, metalcore, post-hardcore, screamo
From First to Last	emo, melodic metalcore, metalcore, pixie, pop punk, post-hardcore, progressive post-hardcore, punk christmas, screamo
Fu Manchu	alternative metal, doom metal, funk rock, garage rock, grunge, neo-psychedelic, psychedelic doom, retro metal, sludge metal, stoner metal, stoner rock
Funeral for a Friend	british alternative rock, emo, metalcore, pop punk, post-hardcore, punk christmas, screamo
Funeral Party	dance-punk, new rave
Futuristic	deep underground hip hop, dwn trap, pop rap, rap, underground pop rap
G-Eazy	pop rap, rap, underground pop rap
Gabe Kubanda	No data
Gallows	british alternative rock, chaotic hardcore, melodic hardcore
Gaslight Anthem	melodic hardcore, pop punk, punk, skate punk
Gatsby's American Dream	Indie rock
GBH	brazilian punk, crossover thrash, hardcore punk, oi, punk, ska punk, skate punk
Germs	hardcore punk, punk
Get Scared	emo, metalcore, otacore, pixie, pop punk, post-screamo, screamo
The Get Up Kids	alternative emo, alternative rock, dreamo, emo, emo punk, indie pop, indie rock, melodic hardcore, pop punk, pop rock, post-hardcore, punk, skate punk
The Ghost Inside	death core, melodic metalcore, metalcore, rap metal, screamo
Ghost Town	pixie, screamo
Gideon	christian hardcore, christian metal, death core, deep melodic metalcore, melodic metalcore, metalcore, progressive deathcore, screamo
Gil Mantera's Party Dream	Synthpop, Electronica
The Gilligans	No data
Gin Wigmore	kiwi rock
Glassjaw	alternative metal, dreamo, emo, mathcore, metalcore, nu metal, pop punk, post-hardcore, progressive post-hardcore, screamo
Go Crash Audio	No data
Go Jimmy Go	punk christmas, ska, ska punk, ska revival, traditional ska
Go Radio	alternative pop rock, emo, pixie, pop emo, pop punk, punk christmas
Gob	canadian indie, pop punk, punk, skate punk
Godsmack	alternative metal, alternative rock, groove metal, nu metal, post-grunge, rap metal, rap rock, rock
Gogol Bordello	garage rock
Going Second	No data
Goldfinger	heavy christmas, pop punk, pop rock, post-grunge, punk, punk christmas, ska, ska punk, skate punk
Goldhouse	indie poptimism
Good Charlotte	alternative metal, emo, pop punk, pop rock, post-grunge, punk
Good Guys In Black	No data
Good Riddance	hardcore punk, melodic hardcore, orgcore, pop punk, punk, ska punk, skate punk
The Goodwill	Post-hardcore, Pop-punk
The Gospel Youth	anthem emo, pixie
The Graduate	dreamo
Gratitude	emo, grunge pop
Greek Fire	No data
Greeley Estates	metalcore, post-hardcore, progressive post-hardcore, screamo
The Green	polynesian pop, reggae rock
Green Day	alternative rock, permanent wave, pop punk, pop rock, punk, rock
Greg Wood	guitar case
Grey Gordon	anthem emo
Grieves with Budo	No data
The Gufs	grunge pop
Guttermouth	hardcore punk, melodic hardcore, pop punk, punk, ska, ska punk, skate punk
Gwar	alternative metal, comic, crossover thrash, funk rock, groove metal, industrial metal, industrial rock, metal, nu metal, rap rock, speed metal, thrash metal
Gym Class Heroes	dance pop, emo, pop, pop punk, pop rap
Hail the Sun	dreamo, progressive post-hardcore, screamo
Halifax	Pop punk, melodic hardcore, post-hardcore
Handguns	alternative emo, anthem emo, melodic hardcore, pixie, pop emo, pop punk
Hands Like Houses	metalcore, pixie, post-screamo, progressive post-hardcore, screamo
Haste the Day	christian christmas, christian hardcore, christian metal, death core, heavy christmas, melodic metalcore, metalcore, punk christmas, screamo
Hatebreed	alternative metal, groove metal, hardcore, industrial metal, melodic metalcore, metal, metalcore, nu metal, rap metal, rap rock
Have Mercy	alternative emo, anthem emo, pixie, pop punk
Hawthorne Heights	alternative metal, emo, metalcore, pixie, pop emo, pop punk, post-hardcore, screamo
Heart To Heart	alternative emo, anthem emo, deep pop punk
He Is Legend	christian metal, dreamo, mathcore, melodic metalcore, metalcore, post-hardcore, progressive post-hardcore, screamo
Hed PE	alternative metal, funk rock, groove metal, industrial metal, nu metal, post-grunge, rap metal, rap rock
The Heirs	No data
Hello Beautiful	Alternative rock
Hellogoodbye	emo, indie christmas, indie pop, pop emo, pop punk, pop rock, punk christmas
Helmet	alternative metal, alternative rock, funk rock, groove metal, grunge, industrial metal, industrial rock, nu metal, post-grunge, post-hardcore, rap metal, rap rock, space rock, stoner rock
Hepcat	rock steady, ska, ska punk, ska revival, traditional ska
Heritage	dancehall, lovers rock, reggae, reggae fusion, roots reggae
Hey Monday	alternative pop rock, candy pop, emo, pixie, pop emo, pop punk, post-teen pop, punk christmas
HiFi Handgrenades	No data
The Higher	emo, pop emo, pop punk
High School Football Heroes	ska, ska punk
Hit the Lights	alternative emo, anthem emo, emo, pixie, pop emo, pop punk, screamo
Home Grown	emo, heavy christmas, pop punk, punk christmas, ska punk, skate punk
Honor Bright	deep pop emo
Hope	choral, classical performance, compositional ambient, minimal, violin
Hopesfall	christian hardcore, mathcore, melodic metalcore, metalcore, post-hardcore, screamo
Horrorpops	horror punk, psychobilly, rockabilly
Hostage Calm	alternative emo, melodic hardcore
Hot Rod Circuit	dreamo, emo, emo punk, pop punk, punk christmas
Hot Water Music	alternative emo, emo, emo punk, folk punk, melodic hardcore, orgcore, pop punk, post-hardcore, punk, ska punk, skate punk
H2O	hardcore, hardcore punk, melodic hardcore, pop punk, punk, ska punk, skate punk, straight edge
The Human Abstract	christian metal, death core, djent, mathcore, melodic metalcore, metalcore
Hundredth	alternative emo, anthem emo, metalcore, screamo, screamocore
Hunter Revenge	Alternative rock, punk rock, horror punk, hardcore punk, R&B
Hyro Da Hero	british alternative rock
I Am the Avalanche	alternative emo, anthem emo, emo, melodic hardcore, pop punk
I Am Ghost	metalcore, screamo
I Call Fives	alternative emo, anthem emo, pixie, pop punk
I Fight Dragons	antiviral pop, chiptune, comic, nintendocore, otacore, video game music
I Killed The Prom Queen	death core, melodic metalcore, metalcore, screamo
I Prevail	alternative metal, pixie, pop punk, rap metal, screamo
I Set My Friends On Fire	electropowerpop, metalcore, nintendocore, progressive post-hardcore, screamo
I See Stars	emo, metalcore, nintendocore, pixie, pop punk, post-screamo, screamo
I, the Breather	christian hardcore, christian metal, death core, djent, melodic metalcore, metalcore, post-post-hardcore, post-screamo, rap metal, screamo
I the Mighty	bay area indie, dreamo, pixie, post-screamo, progressive post-hardcore, screamo
Ice Nine Kills	metalcore, pixie, pop punk, post-screamo, screamo
Ice-T	chicano rap, gangster rap, hardcore hip hop, hip hop, old school hip hop, rap, west coast rap
Icon For Hire	christian alternative rock, gothic alternative, otacore, pixie, pop emo, post-screamo
illScarlett	canadian indie, punk christmas, reggae rock
Immortal Technique	alternative hip hop, east coast hip hop, gangster rap, hardcore hip hop, hip hop, rap
Impending Doom	christian hardcore, christian metal, death core, melodic metalcore, metalcore, progressive deathcore
In Hearts Wake	Metalcore
In this Moment	alternative metal, gothic symphonic metal, melodic metalcore, metalcore, nu metal, post-grunge, rap metal, rap rock
Incubus	alternative metal, alternative rock, funk metal, funk rock, heavy christmas, nu metal, pop christmas, pop rock, post-grunge, rap metal, rock
The Indecent	beats
Indofin	No data
InnerPartySystem	electropowerpop
Insomniac	No data
The (International) Noise Conspiracy	swedish indie rock
The Interrupters	punk, ska, ska punk, skate punk
Into It. Over It.	alternative emo, anthem emo, chicago indie, dreamo, emo, emo punk, melodic hardcore, pop punk
Ionia	No data
Isles	metalcore, progressive post-hardcore, screamo
Issues	emo, metalcore, pixie, pop punk, post-screamo, screamo
It Boys!	alternative pop rock, electropowerpop
It Dies Today	christian christmas, christian hardcore, christian metal, death core, heavy christmas, melodic metalcore, metalcore, punk christmas, screamo
It's Pouring on Our Heads	No data
Itch	No data
Ivens	No data
ivy league	No data
Iwrestledabearonce	death core, mathcore, melodic metalcore, metalcore, nintendocore, screamo
Jacky Jasper	No data
Jack's Mannequin	dreamo, emo, indie pop, neo mellow, piano rock, pop emo, pop punk, pop rock
James Morris	deep groove house
Jay Tea	No data
Jeffree Star	electropowerpop, pixie, strut
Jet Lag Gemini	deep pop emo
Jimmy Eat World	alternative metal, alternative rock, emo, neo mellow, pop christmas, pop punk, pop rock, post-grunge, punk christmas
Jimmy 2 Times	No data
Joan Jett and the Blackhearts	Rock, hard rock, punk rock
The Johnstones	punk christmas, ska, ska punk
The Jukebox Romantics	No data
Jule Vera	pixie, pop emo
The Juliana Theory	christian punk, dreamo, emo, emo punk, pop punk
Juliet Simms	deep talent show, pixie
Jumping Monks	No data
June	west coast trap
June Divided	gothic alternative, pop emo
The Junior Varsity	dreamo, emo, pop punk
Just Surrender	emo, pop emo, pop punk, screamo
Jurassic 5	alternative hip hop, gangster rap, hardcore hip hop, hip hop, rap, trip hop, turntablism
Justina	No data
K.Flay	escape room, hip pop, indie poptimism, indietronica
K-os	alternative hip hop, canadian indie, hip hop, pop rap
Kaddisfly	dreamo, progressive post-hardcore
Kairo Kingdom	catstep, complextro, filthstep, zapstep
Karate High School	Pop punk, post-hardcore, experimental rock, electronicore, power pop, Nintendocore, alternative rock
The Karma Killers	indie rockism
Katy Perry	dance pop, pop, pop christmas, post-teen pop
Kaya Stewart	R&B, EDM, pop
The Kenneths	No data
Kid Rock	alternative metal, hard rock, nu metal, post-grunge, redneck, rock
Killswitch Engage	alternative metal, groove metal, melodic metalcore, metalcore, nu metal, post-grunge, rap metal, rap rock
Kiros	christian alternative rock, christian rock
Knocked Loose	alternative emo, anthem emo, metalcore, screamo
The Know How	Ska, pop punk
Knuckle Puck	alternative emo, anthem emo, emo, pixie, pop punk, screamo
Koji	No data
Koo Koo Kanga Roo	Dance-pop, hip hop, synthpop, children's music
Kool Keith	abstract hip hop, alternative hip hop, east coast hip hop, gangster rap, hardcore hip hop, hip hop, turntablism
Kosha Dillz	Jewish hip hop
Kottonmouth Kings	nu metal, rap metal, rap rock, redneck
L7	alternative rock, electroclash, funk rock, grunge, post-grunge, punk, riot grrrl, rock
Lagwagon	melodic hardcore, pop punk, punk, ska punk, skate punk
Large Marge	No data
Larry And His Flask	folk punk, ska punk
Lars Frederiksen and the Bastards	oi, punk, ska, ska punk, skate punk
Last Great Assault	No data
Latex Generation	punk rock
L.E.S. Stitches	No data
Le Castle Vania	Electronica, alternative dance, electronic rock
Lee Corey Oswald	No data
Less Than Jake	emo, melodic hardcore, pop punk, pop rock, post-grunge, punk, ska, ska punk, skate punk
The Letters Organize	Hardcore punk, Post-hardcore
Letter Kills	emo, pop punk, screamo
Life on the Sideline	No data
LIGHTS	indie pop, indie r&b, indietronica
Like Moths to Flames	death core, melodic metalcore, metalcore, pixie, post-screamo, screamo
Like Pacific	alternative emo, anthem emo, pixie, pop punk
Lillix	candy pop, post-teen pop, power-pop punk
Limp Bizkit	alternative metal, alternative rock, funk metal, nu metal, pop punk, post-grunge, rap metal, rap rock, rock, wrestling
Linkin Park	alternative metal, nu metal, post-grunge, rap metal
Lionize	reggae rock
Lionz of Zion	No data
The Living End	australian alternative rock, australian pop, pop punk, punk, skate punk
Living With Lions	alternative emo, anthem emo, melodic hardcore, pop punk
Long Beach Dub All-Stars	Reggae, ska, dub, punk rock
Longway	crunk, deep southern trap, deep trap, dirty south rap, dwn trap, gangster rap, rap, southern hip hop, trap music
Look What I Did	mathcore
The Lordz	Hip hop, Mafioso rap, Alternative rock, Punk rock, Rap rock, East Coast hip hop
Loser's Luck	No data
The Lost Boys	No data
Lost In Atlantis	No data
Lost In Society	No data
Lost Point	No data
Lostprophets	alternative metal
Love Equals Death	melodic hardcore, punk, skate punk
Lucero	Alternative country, Punk rock, Alternative rock, Heartland rock, Memphis soul, Country punk, Blues rock
Luckie Strike	No data
Ludo	pop punk
Lunachicks	power-pop punk, riot grrrl
M4Sonic	catstep
Mac Lethal	abstract hip hop, underground pop rap, underground rap
Machine Gun Kelly	pop rap, rap, southern hip hop, trap music
Machree	No data
Macy Kate	channel pop, viral pop
Mad Caddies	melodic hardcore, punk, ska, ska punk, skate punk
Madcap	pop punk
Madchild	rap rock
Madina Lake	emo, pop emo, pop punk, screamo
Mae	indie rock, emo
The Maine	alternative pop rock, emo, neo mellow, pixie, pop, pop emo, pop punk, pop rock, post-teen pop, punk christmas
Major League	alternative emo, anthem emo, melodic hardcore, pixie, pop punk
Make Do and Mend	alternative emo, melodic hardcore
Mallory Knox	alt-indie rock, british alternative rock, pixie
Man Overboard	alternative emo, anthem emo, emo, melodic hardcore, pixie, pop emo, pop punk, punk christmas, screamo
Manic Hispanic	hardcore punk
Manic Sewing Circle	punk ska
Marina City	pixie
Marissa Mishelle	No data
Marmozets	alt-indie rock, british alternative rock, pop emo
Masked Intruder	folk punk, melodic hardcore, orgcore, pop punk, power-pop punk, punk, punk christmas, ska punk, skate punk
Massive Monkees	Breaking
Matchbook Romance	emo, pop punk, post-hardcore, screamo
The Matches	deep new americana, modern blues, new americana
Matisyahu	reggae fusion
Matt Toka	No data
Mayday Parade	emo, neo mellow, pixie, pop emo, pop punk, pop rock, screamo
Maylene & The Sons Of Disaster	christian hardcore, christian metal, melodic metalcore, metalcore, screamo
MC Chris	comic, nerdcore
MC Lars	comic, nerdcore
MC Lars with Weerd Science	Hip hop, rock, alternative rock, progressive rock, new prog
Medium Troy	No data
Me First and the Gimme Gimmes	comic, heavy christmas, melodic hardcore, pop punk, punk, punk christmas, ska, ska punk, skate punk
Me Like Bees	No data
Meg & Dia	candy pop, pop christmas, pop emo, punk christmas, slc indie
Meghann Wright	No data
Memphis May Fire	metalcore, pixie, post-screamo, rap metal, screamo
The Menzingers	alternative emo, anthem emo, emo, indie punk, melodic hardcore, orgcore, pop punk, punk, skate punk
Mestmothe	Pop punk, punk rock, ska punk, alternative rock, melodic hardcore
Metro Station	electropowerpop, emo, pixie, pop punk, punk christmas
MewithoutYou	alternative emo, dreamo, emo, indie folk, progressive post-hardcore, screamo
M.I.A.	alternative dance, dance pop, escape room, hip pop, indie r&b, new rave, pop
Microwave	alternative emo, anthem emo, dreamo, emo, pixie, pop punk, progressive post-hardcore, screamo
Middleground	No data
Middle Class Rut	stomp pop
Middle Finger Salute	Punk rock, pop punk, alternative rock
Midnight To Twelve	grunge pop, hard alternative
Midtown	emo, pop punk, skate punk
MI6	No data
The Mighty Mighty Bosstones	alternative rock, boston rock, heavy christmas, pop punk, pop rock, punk, punk christmas, ska, ska punk, skate punk
Mighty Mongo	No data
Mike Posner	dance pop, pop, pop rap, post-teen pop, tropical house
Mike Watt + The Missingmen	Punk rock, hardcore punk, post-punk, alternative rock, art rock
Millencolin	melodic hardcore, pop punk, punk, skate punk
Millionaires	strut
Miracle Dolls	No data
The Misfits	Horror punk, hardcore punk, punk rock
Miss May I	death core, melodic metalcore, metalcore, post-screamo, rap metal, screamo
Mixtapes	alternative emo, anthem emo, folk punk, melodic hardcore, orgcore, pop punk
Mo Bigsley	No data
Mod Sun	underground pop rap
Moe Pope	flick hop, underground rap
Mojo Morgan	No data
Molotov	deep latin hip hop, latin alternative, latin hip hop, rock en espanol
Moments in Grace	grunge pop
Moneen	dreamo, emo, emo punk, pop punk, screamo
Montage	baile funk
Monty are I	No data
Moose Blood	alternative emo, anthem emo, emo, pixie, pop punk
More To Monroe	No data
Morgan Heritage	dancehall, lovers rock, reggae, reggae fusion, roots reggae
Mother Feather	indie punk
Motion City Soundtrack	emo, pop punk, pop rock, screamo
Motionless in White	alternative metal, melodic metalcore, metalcore, nu metal, pixie, post-screamo, rap metal, rap rock, screamo
Movements	alternative emo, anthem emo, pixie, progressive post-hardcore
The Movielife	alternative emo, emo, emo punk, melodic hardcore, pop punk, skate punk
Moving Mountains	alternative emo, anthem emo, dreamo, emo punk, post rock, progressive post-hardcore, screamo
The Muffs	alternative pop, power-pop punk
Municipal Waste	crossover thrash, death metal, groove metal, hardcore punk, metal, punk, rva indie, speed metal, thrash metal
Murder City Devils	garage rock, hardcore punk, post-hardcore, punk, punk blues
Mushroomhead	alternative metal, groove metal, industrial metal, industrial rock, melodic metalcore, metalcore, nu metal, post-grunge, rap metal, rap rock
Mutemath	christian alternative rock, dreamo, indie pop
MxPx	christian christmas, christian punk, emo, heavy christmas, melodic hardcore, pop punk, pop rock, punk, punk christmas, ska, ska punk, skate punk
My American Heart	punk christmas
My Arcadia	pop emo
My Chemical Romance	emo, pop punk, punk christmas, screamo
Naked Walrus	No data
The Narrative	dreamo
Near Miss	fast melodic punk, melodic hardcore
Neck Deep	alternative emo, anthem emo, emo, pixie, pop punk, screamo
Neo Geo	No data
N.E.R.D	hip hop, indie r&b, pop rap, rap
Never Shout Never	alternative pop rock, emo, pixie, pop punk, post-teen pop
New Beat Fund	No data
New Empire	Pop rock, Rock, pop, alternative
New Found Glory	emo, heavy christmas, pixie, pop punk, pop rock, post-grunge, punk, punk christmas, screamo, skate punk
The New Low	post-screamo
The New Sincerity	No data
New Years Day	candy pop, emo, pixie, pop emo, pop punk, screamo
Night Argent	No data
Night Riots	indie pop, indie poptimism, indie psych-rock, indie rockism, indietronica, shimmer pop
NiT GriT	brostep, filthstep, glitch hop
No Bragging Rights	metalcore, screamo
No Doubt	alternative rock, dance pop, permanent wave, pop, pop christmas, pop rock, post-grunge, punk christmas
NOFX	alternative rock, heavy christmas, melodic hardcore, pop punk, punk, punk christmas, skate punk
No Man's Land	No data
Nonpoint	alternative metal, groove metal, industrial metal, latin metal, melodic metalcore, metalcore, nu metal, post-grunge, rap metal, rap rock
Norma Jean	christian hardcore, christian metal, death core, djent, dreamo, mathcore, melodic metalcore, metalcore, post-hardcore, progressive post-hardcore, screamo
No Use for a Name	emo, melodic hardcore, pop punk, punk, ska punk, skate punk
Nothington	alternative emo, folk punk, melodic hardcore, orgcore, power-pop punk, punk, skate punk
Now On	post-post-hardcore, post-screamo
Obtik	No data
Oceana	No data
Oceans Ate Alaska	death core, metalcore, post-post-hardcore, post-screamo, screamo
Of Mice & Men	alternative metal, emo, metalcore, pixie, pop punk, post-screamo, rap metal, screamo
The Offspring	alternative metal, alternative rock, permanent wave, pop punk, pop rock, post-grunge, punk, rock, skate punk
Oh No Fiasco	No data
Oh, Sleeper	christian hardcore, christian metal, death core, dreamo, melodic metalcore, metalcore, progressive post-hardcore, screamo
Old Wounds	chaotic hardcore
On The Surface	No data
Onward, Etc.	No data
Oneyedjacks	No data
One Last Shot	No data
One Minute Silence	alternative metal, groove metal, industrial metal, nu metal, rap metal, rap rock
One Ok Rock	anime, j-metal, j-pop, j-rock, otacore
Only Crime	fast melodic punk, melodic hardcore, orgcore, punk, skate punk
Orange 9mm	rap metal, rap rock
Ore Ska Band	J-ska, ska punk, pop punk
Othello	No data
Our Last Night	emo, metalcore, pixie, pop punk, post-screamo, rap metal, screamo
Outasight	underground pop rap
Over It	alternative emo, anthem emo, chicago indie, dreamo, emo, emo punk, melodic hardcore, pop punk
Owen Plant	No data
Ozma	Alternative rock, power pop, indie pop, pop punk
P.O.S	abstract hip hop, escape room, underground rap
Pacific Dub	reggae rock
Paige Wood	No data
Palaye Royale	pixie, vegas indie
Panima	deep pop emo, pop emo
Papa Roach	alternative metal, alternative rock, nu metal, pop punk, post-grunge, rap metal, rap rock, rock
Paramore	candy pop, emo, pop, pop emo, pop punk
Parkway Drive	alternative metal, groove metal, melodic metalcore, metalcore, nu metal, rap metal, screamo
Passafire	reggae rock
Patent Pending	pixie, pop emo, pop punk
Pathway To Providence	No data
Pato	dancehall, lovers rock, reggae, reggae fusion, roots reggae
Peelander-Z	j-punk
Pendleton	Punk rock, Skate punk
Pennywise	melodic hardcore, pop punk, punk, skate punk
Pepper	reggae rock
Permanent Bastards	deep orgcore
Peter DiStefano	No data
Phathom	No data
The Photo Atlas	Indie rock, Dance-punk
Pierce the Veil	metalcore, pixie, pop punk, screamo
Pietasters	ska, ska punk, ska revival, traditional ska
The Pinker Tones	spanish rock
The Pink Slips	No data
The Pink Spiders	pop punk
Piotta	italian hip hop, italian pop
Pistolita	Indie rock, Piano rock, Progressive, Emo
Places And Numbers	No data
Plague Vendor	indie punk
Plain White T's	emo, neo mellow, pop, pop christmas, pop punk, pop rock, post-teen pop, punk christmas
Planet Smashers	ska, ska punk, ska revival
Playboy Manbaby	No data
PlayRadioPlay	alternative pop rock
Poison the Well	chaotic hardcore, christian hardcore, death core, mathcore, melodic metalcore, metalcore, post-hardcore, screamo
Polar Bear Club	alternative emo, anthem emo, emo, melodic hardcore, orgcore, pop punk, skate punk
Pour Habit	fast melodic punk, melodic hardcore, skate punk
Preston	chicago soul, classic funk rock, disco, funk, funk rock, jazz blues, memphis soul, motown, new orleans blues, quiet storm, soul, soul blues, southern soul
The Pretty Reckless	alternative metal, candy pop, pop, pop punk, post-grunge, post-teen pop
Prof	abstract hip hop, underground pop rap, underground rap
Protest The Hero	canadian metal, death core, djent, jazz metal, mathcore, melodic metalcore, metalcore, post-hardcore, progressive metal, progressive post-hardcore, screamo
The Protomen	comic, deep chiptune, video game music
Psycho White	No data
Psychotic 4	No data
Pull The Pin	No data
PVRIS	emo, indie poptimism, pixie, pop, pop emo, pop punk, screamo
Quarashi	icelandic pop, rap metal, rap rock
Quicksand	emo, emo punk, grunge, hardcore, math rock, mathcore, melodic hardcore, post-hardcore, space rock, straight edge
Railroad To Alaska	No data
Rancid	alternative rock, funk rock, pop punk, punk, ska, skate punk
The Randies	power-pop punk
Rapid Decline	No data
RDGLDGRN	Hip hop, indie rock, alternative rock, go-go
The Ready Set	alternative pop rock, emo, indie poptimism, pixie, pop, pop emo, pop punk, post-teen pop, punk christmas, teen pop, viral pop
Real Friends	alternative emo, anthem emo, emo, pixie, pop punk, screamo
Real McKenzies	celtic rock, punk, skate punk
The Receiving End of Sirens	dreamo, post-hardcore, progressive post-hardcore, screamo
Reckless Serenade	anthem emo
The Recovering	No data
Red Car Wire	alternative pop rock
Red Five	bubble trance
The Red Jumpsuit Apparatus	alternative metal, christian alternative rock, emo, metalcore, neo mellow, pixie, pop punk, pop rock, post-grunge, screamo
Reel Big Fish	comic, pop punk, pop rock, post-grunge, punk, ska, ska punk, skate punk
Reggie and the Full Effect	emo, emo punk, pop punk, post-hardcore, screamo
Relient K	ccm, christian alternative rock, christian christmas, christian music, christian punk, christian rock, emo, indiecoustica, neo mellow, pop christmas, pop punk, pop rock, punk christmas, worship
Remsa 'n Event	No data
Rev 9	No data
Reverend Horton Heat	funk rock, garage rock, psychobilly, punk, punk blues, rockabilly, surf music
Revolution Mother	No data
Rise Against	alternative metal, hardcore punk, nu metal, pop punk, post-grunge, punk
Rise To Remain	melodic metalcore, metalcore
The Riverboat Gamblers	Punk rock, garage rock, alternative rock
River City Extension	Indie folk, Alternative rock
Roam	alternative emo, anthem emo, pixie, pop punk
Rocket from the Crypt	alternative rock, garage rock, math rock, post-hardcore, punk, punk blues, punk christmas
The Rocket Summer	alternative pop rock, dreamo, emo, neo mellow, piano rock, pop christmas, pop emo, pop punk, pop rock, punk christmas
Roger Miret and the Disasters	oi
Rollins Band	funk metal, funk rock, grunge, punk, rap rock
Roses Are Red	screamo
Royal Crown Revue	swing, traditional swing
Rufio	emo, melodic hardcore, pop punk, punk, screamo, skate punk
Run DMT	indie dream pop, vaporwave
Rx Bandits	dreamo, pop punk, progressive post-hardcore, ska, ska punk
Ryan Cassata	Folk rock, indie, alternative
Safe To Say	alternative emo, anthem emo
Saint Alvia	Rock, Punk, Reggae
The Salads	Ska punk, reggae fusion, punk rock
Sammy Adams	pop rap, underground pop rap
Sarah and the Safe Word	No data
Save Ferris	ska, ska punk
Saves the Day	alternative emo, dreamo, emo, melodic hardcore, pop punk, pop rock, post-hardcore, screamo, skate punk
Saosin	dreamo, emo, metalcore, pop punk, post-hardcore, progressive post-hardcore, screamo
Saving Grace	christian hardcore, christian metal
Say Anything	alternative emo, dreamo, emo, pop punk, pop rock, screamo
Say No More	deep pop emo, pop emo
SayWeCanFly	pixie, pop emo
Say When	No data
Scare Don't Fear	Rap metal
Scary Kids Scaring Kids	emo, metalcore, pop punk, post-hardcore, progressive post-hardcore, screamo
The Scissors	No data
Seaway	alternative emo, anthem emo, pixie, pop emo, pop punk
Seaweed	emo, emo punk, grunge, math rock, post-hardcore
Secret Broadcast	No data
The Secret Handshake	alternative pop rock, electropowerpop
SECRETS	metalcore, pixie, post-post-hardcore, post-screamo, progressive post-hardcore, screamo
Senses Fail	emo, metalcore, pop punk, post-hardcore, screamo
Separations	post-post-hardcore, post-screamo
Set It Off	electropowerpop, emo, otacore, pixie, pop punk, punk christmas
Set Your Goals	alternative emo, anthem emo, emo, melodic hardcore, pop punk, post-hardcore, screamo, skate punk
Settings	orgcore
Sevendust	alternative metal, alternative rock, groove metal, industrial metal, melodic metalcore, metalcore, nu metal, post-grunge, rap metal, rap rock
Shad	deep trap, trap music
Sharks	death core, melodic metalcore, metalcore, post-screamo, screamo
Shattered Sun	Heavy metal, thrash metal, metalcore
The Sheds	alternative emo
Shinobi Ninja	Rock, Hip Hop, Metal, Punk, Reggae, Funk, Electronic
Shira	No data
Shiragirl	riot grrrl
Shooter Jennings	alternative country, country rock, outlaw country, redneck, southern rock, texas country, traditional country
Shot In The Dark	No data
Shut Up And Deal	No data
Shwayze	pop rap, underground pop rap
Shy KidX	No data
Sick City	deep pop emo
Sick of It All	alternative metal, crossover thrash, groove metal, hardcore, hardcore punk, melodic hardcore, punk, rap metal, rap rock, ska punk, skate punk, straight edge
Sick of Sarah	Power Pop, Indie Rock
Silent Planet	christian hardcore, christian metal, metalcore, post-screamo, progressive post-hardcore, screamo
The Silver Comet	No data
Silverstein	emo, metalcore, pixie, pop punk, post-hardcore, screamo
Simple Plan	emo, heavy christmas, neo mellow, pop, pop punk, pop rock, post-grunge, post-teen pop, punk christmas
Sing It Loud	alternative pop rock, pop emo, pop punk
Single File	pop punk
Six Feet Under	alternative metal, brutal death metal, death metal, deathgrind, grindcore, groove metal, latin metal, melodic metalcore, metal, nu metal, rap metal, rap rock, speed metal, technical death metal, thrash metal
Skarhead	crossover thrash, hardcore, straight edge
Skavoovie and the Epitones	ska punk, traditional ska
Skeet Skeet	No data
Skindred	alternative metal, groove metal, heavy christmas, industrial metal, nu metal, post-grunge, rap metal, rap rock, welsh rock
Skinny Lister	Folk, Indie folk
Skip The Foreplay	post-post-hardcore, post-screamo, screamo
Sky Eats Airplane	metalcore, nintendocore, progressive post-hardcore, screamo
Sleeper Agent	Alternative rock
Sleeper Set Sail	No data
The Sleeping	post-hardcore, progressive post-hardcore, screamo
Sleeping With Sirens	metalcore, pixie, pop emo, pop punk, screamo
Sleepwalker	german hip hop
The Smashup	punk christmas
The Smooths	punk ska, ska punk
Snapcase	emo, emo punk, hardcore, mathcore, melodic hardcore, metalcore, post-hardcore, rap metal, straight edge
Snot	alternative metal, funk metal, funk rock, groove metal, industrial metal, nu metal, rap metal, rap rock
So Long Arletta	No data
So They Say	Alternative rock, pop rock, post-hardcore, pop punk
Social Distortion	alternative rock, pop punk, punk, rock, skate punk
Someday Never	deep pop emo
Something Corporate	dreamo, emo, neo mellow, piano rock, pop christmas, pop emo, pop punk, pop rock, punk christmas
Somerset	No data
Sonic Boom Six	ska, ska punk
The Sounds	metropopolis, swedish alternative rock, swedish indie rock
The Specials	britpop, dance rock, madchester, new romantic, new wave, new wave pop, post-punk, punk, reggae, ska, ska punk, ska revival
The Spill Canvas	dreamo, emo, pop emo, pop punk, pop rock, punk christmas, screamo
Spring Heeled Jack	ska, ska punk
Sprout	art rock, britpop, chamber pop, dance rock, madchester, melancholia, new romantic, new wave, new wave pop, synthpop, uk post-punk
Stacked Like Pancakes	Ska, brass-rock, rock
Staind	alternative metal, alternative rock, nu metal, pop rock, post-grunge, rap metal, rap rock, rock
The Starting Line	alternative emo, anthem emo, dreamo, emo, pop emo, pop punk, pop rock, screamo
State Champs	alternative emo, anthem emo, deep pop punk, emo, pixie, pop emo, pop punk
Staylefish	reggae rock
Stepdad	metropopolis, shimmer pop
Stephan Jacobs	glitch hop
Stephen Jerzak	alternative pop rock, electropowerpop
Stick to Your Guns	death core, melodic hardcore, melodic metalcore, metalcore, screamo
Still Remains	christian hardcore, christian metal, groove metal, melodic death metal, melodic metalcore, metalcore, screamo
The Stingrays	No data
Story of the Year	alternative metal, christian alternative rock, emo, melodic metalcore, metalcore, nu metal, pop punk, post-grunge, rap metal, rap rock, screamo
The Story So Far	alternative emo, anthem emo, emo, pixie, pop punk, screamo
Strangers You Know	indie poptimism, indie psych-rock, indie rockism
Strawberry Blondes	No data
Stray from the Path	death core, djent, mathcore, melodic metalcore, metalcore, rap metal, screamo
Straylight Run	dreamo, emo, piano rock, pop punk
Street Dogs	melodic hardcore, oi, punk, ska, ska punk, skate punk
Street Drum Corps	Alternative rock, experimental rock, punk revival, industrial
Streetlight Manifesto	comic, pop punk, punk, ska, ska punk, skate punk
Stretch Armstrong	No data
Strike Anywhere	alternative emo, emo, folk punk, melodic hardcore, orgcore, pop punk, punk, rva indie, ska punk, skate punk
Strung Out	melodic hardcore, pop punk, punk, ska punk, skate punk
Stutterfly	screamo
Sublime	alternative rock, funk rock, pop rock
Suburban Legends	ska, ska punk
Sugarcult	emo, pop punk, pop rock, post-grunge, screamo, skate punk
Sugar Ray	alternative metal, alternative rock, funk metal, funk rock, neo mellow, pop christmas, pop punk, pop rock, post-grunge, punk christmas, rock
Suicidal Tendencies	alternative metal, crossover thrash, funk metal, funk rock, groove metal, grunge, hardcore punk, metal, nu metal, punk, rap metal, rap rock, rock, skate punk, speed metal, thrash metal
Suicide Machines	folk punk, hardcore punk, melodic hardcore, orgcore, pop punk, punk, ska, ska punk, skate punk
Suicide Silence	alternative metal, death core, groove metal, melodic metalcore, metalcore, nu metal, pixie, rap metal, screamo
The Suit	No data
Sum 41	alternative metal, nu metal, pop punk, post-grunge, punk, rap rock
The Summer Set	alternative pop rock, emo, neo mellow, piano rock, pixie, pop, pop emo, pop punk, pop rock, post-teen pop, punk christmas, teen pop, viral pop
The Sunstreak	No data
Supe	hard alternative
Super Water Sympathy	Alternative Rock, Shimmer-Pop
Supernova	Pop punk, punk rock
Survive This!	post-screamo
The Swellers	alternative emo, anthem emo, emo, melodic hardcore, pop punk, skate punk
Swingin' Utters	hardcore punk, melodic hardcore, orgcore, power-pop punk, punk, ska punk, skate punk
Switched	alternative metal, groove metal, industrial metal, nu metal, rap metal, rap rock
Sworn In	death core, metalcore, progressive deathcore, screamo
Sydney	deep indie r&b, escape room, hip hop, indie r&b, neo soul, r&b
Sykes	dance pop, pop, post-teen pop, teen pop, viral pop
Sylar	post-screamo, screamo
T. Mills	pop rap
Taking Back Sunday	emo, pop punk, pop rock, post-grunge, screamo
Talib Kweli	alternative hip hop, dirty south rap, east coast hip hop, hardcore hip hop, hip hop, pop rap, rap, southern hip hop
TAT	skate punk
Taylor Thrash	alternative pop rock
Teenage Bottlerocket	folk punk, melodic hardcore, orgcore, pop punk, power-pop punk, punk, ska, ska punk, skate punk
Ten Second Epic	Alternative rock
Terrible Things	pop punk
Terror	indie poptimism, pop, post-teen pop, teen pop
Tess Dunn	No data
Texas in July	christian hardcore, christian metal, death core, melodic metalcore, metalcore, screamo
There For Tomorrow	christian alternative rock, emo, pixie, pop emo, pop punk, screamo
They All Float	No data
Thirty Seconds to Mars	alternative metal, alternative rock, nu metal, pop punk, post-grunge
This Wild Life	alternative emo, anthem emo, pixie, pop emo, pop punk, screamo
Thrice	alternative metal, dreamo, emo, metalcore, nu metal, pop punk, post-grunge, post-hardcore, punk, screamo, skate punk
Throwdown	alternative metal, christian hardcore, groove metal, hardcore, melodic metalcore, metalcore, nu metal, rap metal, rap rock, straight edge
Throw The Fight	hard alternative, post-screamo
Thursday	alternative emo, dreamo, emo, pop punk, post-hardcore, progressive post-hardcore, screamo
Tiger Army	horror punk, psychobilly, punk, rockabilly, ska punk, skate punk
Tillie	indie rockism
Tilt	deep uplifting trance, epicore
Tip the Van	punk ska, ska, ska punk
Title Fight	alternative emo, anthem emo, emo, indie punk, melodic hardcore, pop punk, screamo
To The Wind	anthem emo, deep melodic metalcore
Tomorrow's Bad Seeds	No data
Tonight Alive	candy pop, emo, pixie, pop emo, pop punk, screamo
Tony D'Angelo	No data
Too Close to Touch	anthem emo, pixie, post-screamo, progressive post-hardcore, screamo
Tornado Rider	No data
Total Chaos	austrian hip hop, crossover thrash, crust punk, hardcore punk, oi, punk, skate punk
Trading Bryson	No artist data
Transit	alternative emo, anthem emo, emo, melodic hardcore, pixie, pop emo, pop punk, screamo
Transplants	pop punk, punk, ska, ska punk, skate punk
Trashing Andi	No data
Treaty of Paris	deep pop emo
Treephort	punk ska
Trophy Eyes	alternative emo, anthem emo, deep australian indie, pixie, pop punk
Trust Company	Alternative metal, nu metal, hard rock, post-grunge
T.S.O.L.	crossover thrash, hardcore punk, horror punk, oi, punk, ska punk, skate punk
Tsunami Bomb	melodic hardcore, pop punk, power-pop punk, punk, ska punk, skate punk
Twilight Creeps	No data
Twin Atlantic	alt-indie rock, british alternative rock, pop punk, scottish rock
Twiztid	horrorcore, rap metal, rap rock, redneck
Underoath	christian metal, dreamo, emo, melodic metalcore, metalcore, pop punk, post-hardcore, progressive post-hardcore, screamo
Unlocking The Truth	No data
Unsane	grunge, math rock, mathcore, noise rock, post-doom metal, post-hardcore, post-metal, sludge metal, space rock
The Unseen	hardcore punk, melodic hardcore, oi, punk, ska punk, skate punk
Unwritten Law	emo, pop punk, post-grunge, punk, skate punk
Upon a Burning Body	death core, groove metal, melodic metalcore, metalcore, nu metal, post-screamo, rap metal, screamo
The Urge	funk rock, ska punk
Urinal Mints	No data
The Used	alternative metal, emo, metalcore, nu metal, pixie, pop punk, pop rock, post-grunge, post-hardcore, screamo
Valencia	anthem emo, dreamo, emo, pop emo, pop punk, punk christmas
Valient Thorr	sludge metal, stoner metal, stoner rock
Vampires Everywhere!	Industrial metal, horror punk, gothic rock
The Vandals	crossover thrash, hardcore punk, heavy christmas, melodic hardcore, pop punk, punk, punk christmas, ska, ska punk, skate punk
The Vanished	grunge pop
Vanna	death core, melodic metalcore, metalcore, post-hardcore, progressive post-hardcore, screamo
Vaux	Alternative rock, Post-hardcore
Veara	alternative emo, anthem emo, deep pop punk, pop punk
Veil Of Maya	death core, djent, mathcore, melodic metalcore, metalcore, rap metal, screamo
Vendetta Red	emo, screamo
VersaEmerge	candy pop, pop emo, punk christmas, screamo
The Vincent Black Shadow	steampunk
Vision of Disorder	alternative metal, groove metal, hardcore, industrial metal, mathcore, metalcore, nu metal, rap metal, rap rock
Volumes	death core, djent, metalcore, rap metal, screamo
Vonnegutt	soul flow, underground pop rap
Voodoo Blue	deep pop emo
Wage War	melodic metalcore, metalcore, post-screamo, rap metal, screamo
Waka Flocka Flame	crunk, dirty south rap, dwn trap, gangster rap, hip hop, pop rap, rap, southern hip hop, trap music, underground hip hop
Wallpaper.	deep australian indie, indie dream pop, vapor soul
War on Women	No data
Waterparks	anthem emo, pixie, pop emo, pop punk
Watsky	abstract hip hop, comic, pop rap, underground pop rap
The Waves	new wave pop
Wax	underground pop rap
We Are The In Crowd	candy pop, emo, pixie, pop emo, pop punk
We Are The Ocean	british alternative rock, screamo
We Came As Romans	emo, melodic metalcore, metalcore, pixie, pop punk, post-screamo, rap metal, screamo
We the Kings	emo, neo mellow, piano rock, pixie, pop, pop punk, pop rock, post-teen pop, teen pop, viral pop
weatherPROOF	No data
Weerd Science	abstract hip hop
Weezer	alternative metal, alternative rock, blues-rock, garage rock, indie christmas, indie pop, indie rock, nu metal, permanent wave, pop christmas, pop punk, pop rock, post-grunge, punk christmas, rock
We're Doomed	No genre
West Beverly	No data
While She Sleeps	melodic metalcore, metalcore, rap metal, screamo
Whitechapel	death core, groove metal, melodic metalcore, metalcore, nu metal, rap metal, screamo
White Kaps	No data
The White Noise	Post-hardcore, melodic hardcore, hardcore punk, metalcore
Wick-It The Instigator	mashup
William Control	electropowerpop, steampunk
Wind In Sails	anthem emo
Winds Of Plague	death core, melodic metalcore, metalcore
Windsor Drive	dreamo, piano rock
